%%%%%%%%%
% %    G%
%   %%  %
%P   G  %
%%%%%%%%%
