%%%%%%%%%
% %     %
%   %%  %
%P   G  %
%%%%%%%%%
